WWWWWWWWWWWWWWWWWWWW
WWWWWWWWWWWWWW   WWW
WWWWWWWWWWW      WWW
WWW           WWWWWW
WWWWWWWWWWW   WWWWWW
WWWWWWWWWWWWW  WWWWW
WWWWWWWWWWWWWWW WWWW
WWWWWWWWWWWWWWW WWWW
WWWWWWWWWWWWWWW WWWW
WWWWWWWWWWWWWWW WWWW
WWWWWWWWWWWWWWWWWWWW
WWWWWWWWWWWWWWWWWWWW
WWWWWWWWWWWWWWWWWWWW
WWWWWWWWWWWWWWWWWWWW
WWWWWWWWWWWWWWWWWWWW