WWWWWWWWWWWWWWWWWWWW
WWWWWWWWWWWWWE   WWW
WWWWWWWEWWW      WWW
WWW              WWW
WWWWWFWWWWW   WWWWWW
WWWWWWWWW      WWWWW
WWWWWWWW    FW  PWWW
WWWWWWW    WWWW WWWW
WWWWWW   WWWWWW WWWW
WWWWWW   WWWWWW WWWW
WWWWW    WWWWWWWWWWW
WWWWW   WWWWWWWWWWWW
WE      WWWWWWWWWWWW
WWWWWWWWWWWWWWWWWWWW
WWWWWWWWWWWWWWWWWWWW